NO ./textures/north.xpm
SO ./textures/south.xpm
WE ./textures/west.xpm
EA ./textures/east.xpm


F 14,211,100
C 255,255,255

111111111111111111111111111111111111111111111111111111111111111111111111111111111111111111
100011000110001100011000110001100011000110000W00000000000000000011000000001100000000110001
100011000110001100011000110001100011000110001100000000000000000011000110001100011000110001
100011000110001100011000110001100011000110001100000000000000000011000110001100011000110001
100011000110001100011000110001100011000110001100000000000000000011000110001100011000110001
100011000110001100011000110001100011000110001100000000000000000011000110001100011000110001
100011000110001100011000110001100011000110001100000000000000000011000110001100011000110001
100011000110001100011000110001100011000110001100000000000000000011000110001100011000110001
100011000110001100011000110001100011000110001100000000000000000011000110001100011000110001
100011000110001100011000110001100011000110001100000000000000000011000110001100011000110001
100011000110001100011000110001100011000110001100000000000000000011000110001100011000110001
100011000110001100011000110001100011000110001100000000000000000011000110001100011000110001
100011000110001100011000110001100011000110001100000000000000000011000110001100011000110001
100011000110001100011000110001100011000110001100000000000000000011000110001100011000110001
100011000110001100011000110001100011000110001100000000000000000011000110001100011000110001
100011000110001100011000110001100011000110001100000000000000000011000110001100011000110001
100011000110001100011000110001100011000110001100000000000000000011000110001100011000110001
100011000110001100011000110001100011000110001100000000000000000000000110000000011000000001
100011000110001100011000110001100011000110001100000000000001100011000110001100011000110001
111111111111111111111111111111111111111111111111111111111111111111111111111111111111111111
