NO ./textures/north.xpm
SO ./textures/south.xpm
WE ./textures/west.xpm
EA ./textures/east.xpm

C 225,30,0
F 220,100,0

1111111
1001011
1010001
1010011
11011N1
1110111