NO ./textures/north.xpm
SO ./textures/south.xpm
WE ./textures/west.xpm
EA ./textures/east.xpm

C 225,30,0
F 220,200,0

        111111111111111111111
        100000000011000000001
        101100000111000000001
        100100000000000000001
11111111101100000111000000001
10000000001100000111011111011
11110111111111011100000010001
11110111111111011101010010001
110000001101010111000000100011
100000000000000011000000100001
1000000000000000110101001000N1
100000000000000011010100100001
100000000000000011010100100011
10000000000000001101010010001
10000000000000001101010010001
10000000000000001101010010001
10000000000000001101010010001
10000000000000001101010010001
10000000000000001101010010001
10000000000000001101010010001
10000000000000001101010010001
10000000000000001101010010001
10000000000000001101010010001
10000000000000001101010010001
10000000000000001101010010001
10000000000000001101010010001
10000000000000001101010010001
10000000000000001101010010001
10000000000000001101010010001
10000000000000001101010010001
10000000000000001101010010001
10000000000000001101010010001
10000000000000001101010010001
10000000000000001101010010001
10000000000000001101010010001
11000001110101011111011110001
11110111111101011101111010001
11111111111111111111111111111