NO ./textures/north.xpm
SO ./textures/south.xpm
WE ./textures/west.xpm
EA ./textures/east.xpm


F 134,211,255
C 255,255,255

                      
111111111111111111111
1000000000000000110011                      
1000000000000000110011
100111111111100000001
100000000111111100001
100000000000000000001
100000111111111100001
100000000000000000001
100111111100000000001  
100000000000000000001
100000000111111100001
100000000100000000001
100000000100000000001
100000011111111000001
100000000000001000001
10000000N000100000011
100000000000000000001
100001000111000000001
100001000000000000011
111111111111111111111





